---config@码表分类=主码-次显码表
---config@码表别名= 隐藏全码
嶅	aofe
𩽾	anan
挨	aifu
唉	aiku
哀	aiwy
案	anbm
铵	anjn
埯	antd
岙	aoye
豳	bbuu
畚	bfst
𠳐	bhke
栟	bfmk
襞	biuy
邶	bwle
煸	bmhc
萆	bicu
舭	bivb
芘	bicb
沘	bidb
诐	biyy
𨚕	bmse
苾	bicb
咇	bikb
祕	bipb
骉	bnmm
埗	butp
蚄	bhif
浡	bodz
琲	bwwf
棓	bwmk
皕	bibb
鲌	baab
攽	bjbw
欂	bomc
鞁	bwgy
蔀	buce
幖	bnjx
馝	bihb
𨭉	bjwj
半	bjdl
爸	babb
把	bafb
报	bcfy
拔	bafd
吧	bakb
耙	balb
粑	bamb
滨	bbdb
瀑	bcdu
爆	bchu
暴	bcou
豹	bcvu
笨	bfvb
蚌	bhif
棒	bhml
傍	bhrf
比	bibb
毙	bibb
庇	bigb
闭	bimc
璧	biuy
碧	biwu
避	bizu
搬	bjfy
瓣	bjlu
般	bjvy
班	bjww
冰	bkdu
柄	bkmb
饼	bkuk
鞭	bmgg
扁	bmhc
辩	bmlu
辫	bmlu
编	bmsc
遍	bmzc
标	bnmx
博	bouc
捕	buff
哺	bukf
卜	buld
布	buuj
补	bupb
埠	butu
碑	bwuu
悖	bwxz
部	bule
板	bjmy
鸨	bcbn
龅	bcvs
趵	bczu
稗	bdhu
佰	bdrb
薜	bicu
秕	bihb
俾	biru
愎	bixw
跸	bizu
坂	bjty
槟	bkmb
褊	bmpc
砭	bmuf
笾	bmvz
忭	bmxb
镖	bnjx
婊	bnny
铂	bojb
钚	bujb
瓿	bulw
呗	bwkr
褙	bwpo
孛	bwuz
箅	bivl
阪	bjey
箔	bovb
铋	bijb
犇	bfnn
熜	cshx
䅟	cjhp
粢	cidm
词	ciyk
材	cdmc
苍	chcv
仓	chrv
祠	cipk
辞	ciqu
残	cjdj
翠	cvxu
锉	cojt
汆	crru
琮	cswx
蔟	cucu
萃	cvcu
毳	cvmm
屌	dnuj
蹾	dyzw
汈	dndd
杕	dimd
饳	doui
垯	datz
炟	dahd
阇	dumo
鱽	dcad
浟	didw
筜	dhve
禘	dipj
𨱏	dajk
䗖	diij
磹	dmuu
的	dibu
读	duyd
瘩	dabk
鿎	dauz
达	dazd
盗	dcdm
代	ddry
等	dgvc
党	dhxe
档	dhme
殿	dmuy
涤	didm
底	digd
缔	disj
帝	diwj
单	djbl
淡	djdh
弹	djgl
蛋	djvi
队	dver
诞	djyz
顶	dkdr
订	dkyd
惦	dmxk
刁	dnva
朵	dojm
驮	domd
多	doxx
迭	dpzu
端	drle
断	drmj
栋	dsmd
度	dugy
都	dule
妒	dunh
独	duqi
钝	dyjt
吨	dykt
敦	dyww
抖	dzfu
都	dzle
胆	djod
靼	dagd
鞑	dagz
褡	dapk
氘	dcql
殆	dddk
谠	dhye
氐	diud
谛	diyj
啖	djkh
疸	djbd
澹	djdk
箪	djvl
惮	djxl
惮	daxl
簟	dmvu
凋	dndk
牒	dppm
煅	drhy
咚	dskd
垌	dstk
黩	duhd
蠹	duai
怼	dvyx
佚	dpru
哒	dakz
羝	diyd
玓	diwu
𬤊	diyr
𬱖	diyr
𬊤	djhl
𬭊	dujt
咡	erke
姶	eenk
崿	eeek
𥔲	eeuk
愕	eexk
耳	eraa
贰	eryr
厄	eeiv
嗯	enkx
偾	ffrr
茀	fucf
氾	fjdv
㕮	fukx
砆	fuuf
𫓧	fujf
垺	futz
蚄	fhif
浲	fgdf
䓛	fuci
𣸣	ffdr
𫔍	fjjt
法	fads
阀	famg
吩	ffkd
粉	ffmd
冯	fgdm
蜂	fgif
放	fhfw
妨	fhnf
肪	fhof
仿	fhrf
访	fhyf
烦	fjhr
贩	fjky
翻	fjpx
矾	fjuf
副	fuad
夫	fuan
富	fubt
扶	fuff
敷	fufw
辅	fuif
脯	fuof
付	furc
俯	furc
弗	fuvl
驸	fumc
匪	fwkf
榧	fwmf
妃	fwnj
诽	fwyf
纷	ffsd
赋	fukv
汾	ffdd
玢	ffwd
彷	fhif
枋	fhmf
舫	fhvf
钒	fjjf
樊	fjmd
梵	fjmf
蜉	fuiz
讣	fuyb
跗	fuzc
痱	fwbf
唪	fgkl
𬸪	fjpn
榖	guuy
饹	geuk
馃	goug
蛄	guik
牿	gunk
嘏	guuy
䢼	gsce
姽	gvnv
珖	glww
唝	gskr
䓛	guci
馉	guuo
廆	gvgg
筦	grve
雊	gzbf
㽏	gjdg
镐	gcjk
羔	gcyh
盖	gdym
歌	gedr
格	gemk
阁	gemk
缸	ghfg
杆	gjmg
肝	gjog
赶	gjtg
敢	gjvw
锅	gojn
过	gozc
官	grbk
罐	grff
棺	grmk
贡	gsgr
汞	gsgu
躬	gsug
谷	gubk
沽	gudk
固	gukk
姑	gunk
股	guoy
鼓	guuy
贾	guxr
龟	gvdv
归	gvle
桂	gvmt
诡	gvyv
跪	gvzv
句	gzbk
钢	ghjx
槁	gcmk
篙	gcvk
庚	gggn
淦	gjdj
莞	grce
龚	gslb
觚	gudg
钴	gujk
诂	guyk
庋	gvgy
癸	gvvt
剐	gxkd
栝	gxmk
磙	gyuy
枸	gzmk
疳	gjbg
筻	ghvg
馘	goba
蜾	goig
哕	hvkx
翃	hsux
竑	hsls
縠	huuy
翚	hvxi
鞨	hegv
冱	hudh
扞	hjfg
烠	hvho
浛	hjdk
㿠	hlbw
翙	hvex
镮	hrjy
咍	hdkk
瑝	hlww
漷	hode
锽	hljw
熇	hehk
皞	hcbu
艎	hlvw
𨱑	hljb
濩	hudy
翯	hexk
耗	hclm
豪	hcwu
害	hdbk
荷	heck
河	hedk
核	hemr
合	herk
行	hhii
杭	hhmj
航	hhvj
捍	hjfg
旱	hjog
徊	hkik
皇	hlbw
蝗	hliw
凰	hljw
恍	hlxw
豁	hobk
惑	hogx
涣	hrdd
缓	hrsy
欢	hryr
沪	hudh
户	hudu
护	hufh
虎	huhj
胡	huuo
汇	hvdk
秽	hvhx
会	hvrs
灰	hvuh
悔	hvxm
滑	hxdg
划	hxgd
桦	hxmu
候	hzru
嗬	hekk
濠	hcdu
嚆	hckk
嗥	hcku
骸	hdgr
涸	hedk
诃	heyk
蚶	hjig
湟	hldw
崡	hjek
邯	hjge
隍	hlew
奂	hrdd
豢	hrju
蕻	hscb
泓	hsds
斛	hudu
烀	huhh
觳	huuy
怙	huxk
浍	hvds
烩	hvhs
珲	hvwi
铧	hxju
骅	hxmu
珲	hywi
瘊	hzbu
逅	hzzk
锪	hojx
黉	hsxb
𬌗	heyk
𬤝	hvyx
杻	izmi
𥻗	iamd
樗	iumk
翀	isxv
珵	igww
惙	ivxy
椆	izmk
梴	ijmz
刬	ijjd
棽	ifmv
摏	isfj
漦	iiwu
蹅	iazd
榇	ifmm
斶	iuji
襜	ijpk
插	iafj
喳	iakd
查	iamd
抄	icfu
炒	ichu
绰	icsu
超	ictk
撤	iefw
撑	igfu
诚	igyi
池	iidy
侈	iirx
齿	iivk
迟	iizi
铲	ijji
闯	ilmm
喘	irke
充	iswe
穿	irby
触	iudi
锄	iujl
初	iupd
础	iuui
醇	iyyz
愁	izhx
畴	iztc
赤	iitd
镲	iajx
碴	iaud
耖	iclu
钗	idji
砗	ieui
抻	iffu
瞠	igot
苌	ihci
徜	ihik
氅	ihxm
茌	iicu
鸱	iidn
蚩	iivi
潺	ijdz
谄	ijyj
踔	iozu
氚	irqi
舂	isfj
种	ishv
艟	isvl
憧	isxl
蜍	iuih
楮	iumo
绌	iusi
怵	iuxu
雠	izrf
槌	ivmz
怊	icxk
铖	igji
浐	ijdi
𬬮	ihji
𬊤	ijhl
浕	jbdd
蒟	juck
龟	jydv
鋆	jytj
颎	jsbr
蒺	jicu
殛	jida
剞	jidd
锩	jrjv
桕	jqmj
僬	jnrh
楗	jmmz
伋	jirj
岊	jpbe
𫘝	jtmn
枅	jimk
泇	jxdk
垍	jitz
秬	juhj
恔	jnxx
姞	jink
𪟝	jifl
埆	jtty
竫	jkll
𫓶	jrjo
枸	jumk
椐	jumk
矞	jtsk
蜐	jpil
𫓹	jijb
滘	jndk
𫖳	jyyr
耤	jilo
瑨	jbwo
斠	jnju
漖	jndw
嶲	jrev
觭	jidk
鹡	jidn
㵐	jtdr
褯	jppj
璥	jkww
穄	jihx
篯	jmvj
燋	jnhh
澽	judu
璬	jnww
𫔎	jtjk
皦	jnbw
瀱	jidd
津	jbdy
尽	jbid
巾	jbll
劲	jbvl
谨	jbya
近	jbzj
锦	jbjj
击	jiak
寄	jibk
藉	jico
急	jidx
奇	jidk
即	jige
稽	jiho
忌	jijx
唧	jike
冀	jilb
机	jimj
嫉	jinu
及	jipn
系	jipx
级	jisj
继	jisv
辑	jiie
圾	jitj
己	jivv
记	jiyj
计	jiyu
迹	jizd
荆	jkcd
径	jkig
竟	jkle
靖	jklo
精	jkmo
晶	jkoo
兢	jkue
劲	jkvl
京	jkwx
惊	jkxx
将	jldc
讲	jlyj
煎	jmbh
兼	jmbn
渐	jmdj
减	jmdk
捡	jmfa
鞯	jmgz
肩	jmho
见	jmke
坚	jmlt
检	jmma
槛	jmmm
间	jmmo
件	jmrn
蕉	jnch
较	jnix
叫	jnkl
娇	jnnl
焦	jnrh
礁	jnuh
酵	jnyz
接	jpfn
洁	jpdk
戒	jpgc
秸	jphk
街	jpii
竭	jplv
价	jprl
界	jptl
诫	jpyc
究	jqbj
疚	jqbj
舅	jqjl
玖	jqwj
卷	jrjv
决	jtdg
决	jtdn
绝	jtsb
诀	jtyn
玦	jtwg
砄	jtug
拒	jufj
据	jufk
锯	jujk
驹	jumk
橘	jumk
局	juuk
惧	juxb
举	juxl
距	juzj
家	jxbu
稼	jxhu
钾	jxjj
加	jxlk
架	jxlm
嫁	jxnu
假	jxry
骏	jymw
君	jyyk
炅	jsoh
妗	jbnv
缙	jbso
矜	jbsv
觊	jiee
嵇	jihe
乩	jilv
骥	jimb
戟	jiug
蓟	jicd
笈	jivj
玑	jiwj
腈	jkoo
憬	jkxx
柬	jman
謇	jmbk
僭	jmro
笕	jmve
戬	jmyg
谏	jmyj
敫	jnbw
峤	jnel
铰	jnjx
醮	jnyh
桀	jpxm
诘	jpyk
炯	jshk
爝	jthc
苣	jucj
飓	jujb
琚	juwk
遽	juzu
蛱	jxij
镓	jxju
枷	jxmk
迦	jxzk
麇	jygh
赆	jbkd
芰	jicy
迳	jkzg
骱	jpgl
醵	juyu
琎	jbwz
𬣡	jmyj
𬂩	jxmj
诳	klyw
闿	kdmj
匼	kekk
炌	kdhl
𫠆	kvur
硁	kgug
竘	kzlk
咖	kakk
考	kclv
客	kebk
渴	kedv
颗	kegr
科	kehu
棵	kemg
坷	ketk
刻	kewd
炕	khhj
馗	kvjz
会	kkrs
枯	kumk
叩	kzke
阔	komk
坑	kgtj
窟	kubi
矼	ksug
咯	kakk
尻	kcuj
铪	kejk
恪	kexk
贶	klke
匡	klkw
刳	kudd
喾	kuxk
睽	kvot
逵	kvzt
垲	kdtj
悝	lixl
崚	lkew
箓	luvu
蓠	licd
舻	luvu
鲡	lial
苈	licl
呖	likl
蠃	lowf
朸	liml
坽	lkts
昽	lsol
珕	liwl
梠	lvmk
倞	llrx
浬	lidl
浰	lidd
悢	llxl
桹	lhml
𫘧	lumu
凓	lidm
溇	lzdn
勠	luxl
憭	lnxx
澪	lkds
簕	levl
翷	lbmx
髎	lngp
聋	lsle
喇	lakd
酪	lcyk
冷	lgds
烺	lhhl
痢	libd
莉	licd
荔	licl
漓	lidd
利	lihd
历	liil
厘	liil
哩	likl
例	lird
砾	liul
离	liwd
璃	liwd
栗	lixm
览	ljle
缆	ljse
岭	lkes
龄	lkvs
令	lkrs
零	lkys
羚	lkys
莨	llcl
梁	lldm
粱	lldm
俩	llrl
亮	llwj
谅	llyx
帘	lmbj
练	lmsd
连	lmzi
疗	lnbl
洛	lodk
骡	lomx
列	lpdd
咧	lpkd
碌	lquu
硫	lquv
窿	lsbu
龙	lsud
胧	lsol
芦	luch
赂	lukk
卢	lulu
绿	lusu
碌	luuu
录	luvu
簏	luvb
露	luyk
虑	lvhx
铝	lvjk
蕾	lwct
勒	lwgl
伦	lyrb
漏	lzdy
娄	lzmn
林	lbmm
乐	lcpd
潦	lndx
辚	lbil
铼	ldjl
嘞	lekl
莨	lhcl
锂	lijl
郦	lile
鹂	liln
枥	liml
骊	liml
俚	lirl
蠡	livi
逦	lizl
漤	ljdn
褴	ljpm
泠	lkds
呤	lkks
囹	lkks
魉	llgl
殓	lmda
雒	lowf
躐	lpzv
骝	lqmt
镏	lqjt
鸾	lrwn
泸	ludu
轳	luiu
橹	lumo
垆	lutu
嘞	lwkl
偻	lzrn
瞵	lbol
楞	lgmf
鬣	lpav
轹	liil
墚	lltm
鹨	lqxn
𬭸	lbjl
𬴊	lbml
𬍛	liwl
郿	mwve
靺	mogm
鹲	mgcn
蟊	mcsi
瘼	mobd
鄚	mcce
渼	mwdd
愐	mmxm
藦	mocu
醾	miym
庙	mngy
吗	makm
嘛	makm
马	mava
貌	mcve
萌	mgco
锰	mgjm
茫	mhcw
米	midm
弥	migx
眯	miom
谜	miyz
铭	mkjk
名	mkxk
丏	mmav
免	mmdv
眠	mmom
寞	mobd
蘑	mocu
漠	modd
没	mody
磨	mogu
摩	mogu
姆	munm
魅	mwgw
枚	mwmw
媒	mwnm
每	mwpm
玫	mwww
霉	mwym
忙	mhxw
秒	mnhu
蝥	mcsi
荬	mdcd
艨	mgvu
麋	migm
幔	mjjy
缦	mjsy
沔	mmdm
沔	mmdv
眄	mmov
眄	mmom
耱	molu
嬷	monm
苜	muco
淼	mnuu
鳗	mjay
帑	nunj
糵	npcm
钠	najn
哪	nake
拿	naru
那	nave
南	njug
娘	nlnl
撵	nmfi
农	nsdn
哪	nwke
妞	nqni
佴	ndre
狃	nqqi
呕	oukx
鼙	piuu
冯	pkdm
帡	pkjk
舥	pavb
蒱	pucf
簰	pdvu
嚭	piuk
配	pwyj
爬	pavb
榀	pbmk
泡	pcds
炮	pchs
彭	pgup
澎	pgdp
庞	phgl
螃	phif
啤	piku
脾	piou
僻	piru
坯	pita
屁	piub
皮	pivy
盘	pjvm
瓶	pkbw
萍	pkcp
票	pnxx
葡	pucf
埔	putf
铺	pujf
沛	pwdl
曝	puou
淠	pidl
嫔	pbnb
匏	pcds
咆	pcks
俳	pdrf
郫	pipe
谝	pmyc
钋	pojb
粕	pomb
洴	pkdk
俜	pkrv
汔	qidq
龟	qqdv
恓	qixx
祇	qipu
鹐	qmdn
褰	qmby
槭	qimx
桤	qimj
愀	qnxh
欹	qidr
汋	qtdu
玘	qiwj
汧	qmdk
矼	qlug
佺	qrrw
洓	qidn
啐	qiku
勍	qkwl
埼	qitk
庼	qkgr
嵚	qber
𨱇	qqjq
傕	qtrf
焌	quhw
墘	qmtq
瑔	qrwu
碏	qtuo
觭	qidk
鼩	qujk
祛	qups
亲	qblm
侵	qbry
柒	qidm
漆	qidu
岂	qiej
启	qihk
棋	qimb
骑	qimk
祈	qipj
砌	qiud
气	qipv
欺	qiqr
起	qitj
轻	qkig
浅	qmdj
黔	qmhv
铅	qmjk
窍	qnbv
切	qpqd
秋	qqhh
蚯	qqiq
泉	qrbu
拳	qrju
瘸	qtbr
渠	qudm
驱	qumx
去	quts
屈	quui
勤	qbnl
矜	qbsv
吣	qbkx
蕲	qicj
芑	qicj
蛴	qiil
耆	qilo
憩	qiqx
蹊	qizd
綮	qkhx
黥	qkhx
磬	qkuu
镪	qlji
骞	qmbm
慊	qmxn
慊	qpxn
巯	qqvv
蛆	quiq
璩	quwu
诎	quyi
俟	qiru
𬮿	qiej
𬨂	qiiu
𬒈	qkxu
𬱖	qkyr
纴	rfsr
讱	rfyr
刃	rfdd
任	rfrr
认	rfyr
壤	rhty
染	rjdm
铷	rujk
糅	rzmm
颥	ruyr
𬙋	rhsy
凇	ssds
洓	sedn
𫗧	suuu
凘	sidj
溞	scdi
飔	sijx
穟	svhz
嘶	sikj
咝	siks
司	sivk
讼	ssys
酥	suyh
随	svez
尿	svuu
碎	svuu
遂	svzu
瑟	sewb
厮	siij
锶	sijx
耜	silk
淞	ssds
涑	sudu
觫	sudu
燧	svhz
飕	szjy
铫	tnjd
㛚	tsny
溏	thdk
栝	tmmk
哃	tskk
烶	tkhz
遆	tizj
溚	tadk
忳	tyxt
䗴	tkiz
碳	tjuh
涛	tcdc
讨	tcyc
趟	thtk
贪	tjrr
坦	tjtd
谭	tjyu
听	tkkj
汀	tkdd
恬	tmxk
腆	tmob
眺	tnod
拓	tofu
驼	tomb
椭	tomo
彤	tsdp
铜	tsjk
同	tskk
桐	tsmk
瞳	tsol
图	tukd
土	tuua
途	tuzh
颓	tvhr
蜕	tvie
头	tzdd
涂	tudh
谈	tjyh
溻	tadx
铊	tajb
榻	tamx
遢	tazx
羰	thyh
锑	tijp
嚏	tikr
悌	tixp
醍	tiyr
郯	tjhe
袒	tjpd
覃	tjxu
町	tktd
霆	tkyz
酮	tsyk
恸	tsxl
钍	tujt
煺	tvhz
铽	tejx
铴	thjp
龆	tnvk
酴	tuyh
𬳿	tumh
湜	uidr
筲	ucvo
秫	uuhu
埏	ujtz
鄃	uure
䴓	uian
浉	uidj
祏	uipu
甡	ufuu
埫	uhtk
隃	uued
棽	ufmv
畬	uert
畤	uitc
鼫	uiju
襫	uipb
闪	ujmr
沙	uadu
杉	uamp
稍	ucho
少	ucxp
舌	ueqk
汤	uhdp
深	ufdm
甚	ufqv
什	ufru
鞘	ucgo
伸	ufru
绅	ufsu
慎	ufxb
胂	ufou
牲	ugnu
胜	ugou
圣	ugyt
尚	uhxk
裳	uhxy
事	uial
实	uibd
拾	uifk
驶	uimu
使	uirl
蚀	uiui
市	uiwj
式	uiyg
扇	ujhx
善	ujyk
蟀	ukiu
烁	uohl
输	uuid
竖	uull
数	uumw
暑	uuoo
属	uuuy
书	uuvd
述	uuzu
谁	uvyf
熟	uzwh
痧	uabu
挲	uadu
艄	ucvo
厍	ueii
砷	ufuu
诜	ufye
渑	ugdd
殇	uhdp
熵	uhhk
墒	uhtk
蓍	uico
炻	uihu
轼	uiig
舐	uiqu
螫	uiti
虱	uivi
鄯	ujye
芟	ujcy
潸	ujdo
舢	ujve
蒴	uoco
澍	uudc
沭	uudu
黍	uuhu
姝	uunv
倏	uurq
绶	uzsy
嗜	uiko
嵊	ugen
珅	ufwu
眚	uguo
殳	uujy
𬳽	ufme
𬬸	uuju
柞	vamv
拃	vafv
摭	vifh
潴	vudo
祗	vipd
轾	viit
卮	vipv
橥	vuqm
𨙸	viue
汋	vodu
扺	vifu
茋	vicd
泜	vidd
铚	vijt
痓	vibt
赒	vzkk
昣	vfop
跱	vizc
滍	vidi
禔	vipr
瑧	vfwh
禛	vfpb
霅	vayk
蠋	vuii
窄	vdbv
炸	vahv
轧	vaiv
喳	vakd
榨	vamv
召	vcdk
找	vcfg
肇	vchy
朝	vcuo
折	vefj
疹	vfbp
镇	vfjb
拯	vgfa
狰	vgql
整	vguv
筝	vgvl
障	vheu
樟	vhmu
旨	vibo
芝	vicv
治	vidk
汁	vidu
秩	vihu
帜	vijb
帙	viju
制	vipd
知	viuk
智	viuo
识	viyb
沾	vjdk
盏	vjjm
占	vjlk
站	vjlk
粘	vjmk
灼	vohu
卓	volu
钟	vsjv
中	vsll
注	vudv
主	vudw
蛛	vuiv
驻	vumv
株	vumv
住	vurv
筑	vuvf
逐	vuzu
椎	vvmf
州	vzdl
咒	vzkj
周	vzkk
执	vifw
棹	vcmu
笊	vcvv
诏	vcyk
蓁	vfch
枕	vfmv
壮	vldu
溱	vfdh
浈	vfdr
瘴	vhbu
璋	vhwu
咫	viib
枳	vimb
踯	vize
跖	vizu
蘸	vjch
湛	vjdv
颛	vrer
篆	vrvu
冢	vsbn
渚	vudo
澍	vudc
邾	vuve
诌	vzye
吒	vakq
鄣	vhle
忮	vixy
舯	vsvv
隹	vvrf
砦	vdvu
怃	wuxw
铻	wujk
鋈	wudj
洧	wwdo
沩	wwdw
隈	wwen
𫇭	wwcw
𣲗	wwdw
忞	wfwx
郚	wuwe
峗	wwev
珸	wuwk
硊	wwuv
琟	wwwf
嵬	wweg
痦	wubk
靰	wugw
煟	wwho
溦	wwdw
鳂	wwan
螱	wwui
亹	wwwq
为	wwdd
顽	wjer
袜	wapm
外	wdxb
瘟	wfbm
稳	wfhx
问	wfmk
文	wfwx
望	whww
完	wjbe
晚	wjov
无	wuav
芜	wucw
污	wudk
巫	wugr
梧	wumk
物	wunw
伍	wurw
悟	wuxk
诬	wuyr
误	wuyt
未	wwan
薇	wwcw
危	wwdv
韪	wwow
巍	wweg
委	wwhn
味	wwkw
伟	wwrw
畏	wwtn
胃	wwto
凹	wala
浯	wudk
鼯	wujk
杌	wumw
婺	wusn
圬	wutk
迕	wuzw
葳	wwcn
闱	wwmw
娓	wwnm
镡	xbju
旬	xybo
恓	xixx
揳	xpfd
澥	xpdn
炘	xbhj
烜	xrhg
豨	xiuj
郄	xixe
渫	xpdm
葸	xicx
螅	xiix
榍	xpmo
痃	xrby
䜣	xiyj
䜣	xbyj
旴	xuoy
诇	xsyk
肸	xiou
钘	xkjk
俙	xirj
饻	xiuy
叚	xxvy
晅	xrog
冔	xuoy
冔	xuky
崄	xmea
骍	xkmu
琄	xrwo
硍	xmug
翈	xxjx
婞	xkng
睎	xioj
醑	xuyo
屃	xiur
穸	xibx
欻	xuhr
湑	xudo
缐	xmsu
瑆	xkwu
碏	xiuo
暅	xrog
𫍽	xryy
憙	xiux
熻	xihx
谿	xipk
酅	xiee
燮	xpwy
𤫉	xpwy
瓖	xlwy
羞	xqyi
馨	xbuo
心	xbdd
锌	xbju
辛	xblu
衅	xbxb
席	xigj
稀	xihj
熄	xihx
吸	xikj
牺	xinx
膝	xiou
禊	xipd
夕	xipd
系	xipx
喜	xiuk
杏	xkmk
星	xkou
猩	xkqu
性	xkxu
醒	xkyu
项	xlgr
香	xlho
详	xlyy
衔	xmii
线	xmsj
消	xndo
硝	xnuo
箫	xnvs
效	xnww
蟹	xpdi
泄	xpdu
械	xpmc
斜	xpru
些	xpve
谐	xpyb
谢	xpyc
渲	xrdg
轩	xrig
玄	xrwy
喧	xrkg
眩	xroy
选	xrze
匈	xsbk
雄	xsuf
凶	xsxk
血	xtpm
削	xtxd
雪	xtye
徐	xuih
婿	xuno
墟	xuty
恤	xuxx
狭	xxqj
霞	xxyy
殉	xydo
循	xyio
驯	xymi
迅	xyzu
咸	xmxk
畜	xuwt
瘕	xxby
晞	xioj
舄	xijh
粞	ximx
嬉	xink
奚	xipd
歙	xirr
硒	xiux
荇	xkci
飨	xlxl
苋	xmce
藓	xmcy
冼	xmde
岘	xmee
蚬	xmie
娴	xmnm
燹	xmuh
跹	xmzz
魈	xngo
骁	xnmw
枭	xnpm
绡	xnso
榭	xpmc
馐	xqui
谖	xryy
噱	xtku
谑	xtya
嘘	xuky
罅	xxfh
黠	xxhk
硖	xxuj
醺	xyyh
菥	xicj
筅	xmve
砉	xufu
儇	xrry
讻	xsyk
𬭳	xijk
𫰛	xkng
𬀪	xmoe
𬹼	xpvl
𬣞	xrya
𬬸	xuju
𬣙	xuyy
𬊈	xyhc
𬘓	xysi
吲	ybky
蝓	yuid
匜	yiky
嵎	yuey
彧	yuad
玙	yuwy
羑	yzyj
颙	ysyr
剡	yjhd
谳	yjyq
纡	yusy
蚰	yziy
嬴	ykwf
螈	yrix
伛	yurx
潆	ykdx
窬	yubd
尢	yzuv
邘	yuye
䜣	ybyj
佁	yirk
沄	yyds
枍	yimv
叕	yiyy
矞	yusk
洢	yidy
骃	ybmd
𫄧	yjsz
烻	yjhz
涢	yydr
浟	yzdw
宧	yibi
扅	yihx
扆	yihy
掞	yjfh
勚	yiul
桯	ykmw
敔	yuww
厣	yjij
鄅	yuye
悆	yurx
焆	yeho
淯	yudo
涴	yrdv
隃	yued
隩	yued
媖	ykny
琟	yuwf
㙘	yctn
棫	yuma
龂	ybvj
𫖮	yier
畬	yurt
馧	yyhm
椸	yimy
潩	yidb
㴔	yidx
扊	yjhh
瑀	yuwy
楪	yemm
歅	yjxr
锳	ykjy
筼	yyvr
艅	yuvh
裛	yiwy
褕	yupd
蕰	yycm
鹝	yian
鹢	yibn
潏	yudk
虤	yjhj
燚	yihh
繄	yikx
黡	yjih
蟫	ybiu
髃	yugy
嬿	yjnh
爚	ythc
夭	ycpd
衙	yaii
吖	yaky
呀	yaky
讶	yayy
引	ybgl
椅	yimk
荫	ybco
蚓	ybil
因	ybkd
摇	ycff
约	ycsu
要	ycxn
邪	yeye
痒	yhby
洋	yhdy
漾	yhdy
秧	yhhy
央	yhln
杨	yhmp
氧	yhqy
益	yibm
溢	yidm
抑	yife
移	yihx
役	yiiy
毅	yily
伊	yiry
依	yiry
壹	yiua
已	yivv
亦	yiwd
悒	yixb
翼	yixb
怡	yixk
议	yiyy
演	yjdb
淹	yjdd
烟	yjhd
衍	yjii
颜	yjir
檐	yjmk
燕	yjnh
严	yjyp
延	yjzv
俨	yjry
颖	ykbr
英	ykcy
莹	ykcy
婴	ykkn
鹦	ykkn
硬	ykug
赢	ykwf
冤	yrbd
院	yree
原	yrix
员	yrkr
缘	yrsu
鸳	yrxn
远	yrze
泳	ysdy
庸	ysgl
咏	ysky
佣	ysry
曰	ytka
约	ytsu
说	ytye
瘐	yuby
宇	yuby
芋	yucy
鱼	yuda
浴	yudk
屿	yuey
狱	yuqq
预	yusr
郁	yuue
玉	yuwd
羽	yuxx
语	yuyk
遇	yuzy
匀	yybd
允	yyse
酝	yyys
有	yzuo
由	yzla
屹	yieq
咦	yiky
贻	yikk
沂	yidj
狺	ybqk
龈	ybvg
夤	ybxb
霪	ybyr
杳	ycmo
瑶	ycwf
烨	yehu
邺	yeye
蛘	yhiy
徉	yhiy
肄	yiby
镒	yijm
翊	yilx
猗	yiqk
圯	yits
彝	yivc
奕	yiwd
劓	yizd
鼹	yjjn
郾	yjke
腌	yjod
鄢	yjve
筵	yjvz
琰	yjwh
恹	yjxq
膺	ykgo
楹	ykmm
沅	yrde
箢	yrvv
瑗	yrwy
羱	yryx
蛹	ysiy
慵	ysxl
钺	ytjv
萸	yucy
揄	yufd
燠	yuhd
煜	yuhl
圄	yukk
禺	yuld
觎	yure
鹬	yusn
熨	yuuh
聿	yuvl
殒	yydr
纭	yyss
熨	yyuh
筠	yyvd
韫	yywm
鱿	yzay
蝣	yziz
铀	yzjy
飏	yhjp
镱	yijx
埏	yjtz
祐	yzpk
珢	ybwg
𬬱	ybjj
𬤇	ybyt
𬬩	yijy
𬨎	yziy
吱	ziky
虸	ziiz
洓	zidn
鄑	ziye
粢	zidm
䎖	zgbx
澡	zcdm
载	zdui
字	zibz
资	zidr
咱	zjkz
昨	zoov
左	zoug
钻	zrjk
总	zsbx
宗	zsbx
棕	zsmx
纵	zssr
族	zufu
醉	zvyu
卒	zuwu
奏	zzft
咂	zakj
仄	zeir
啧	zekr
笮	zevv
缯	zgso
渍	zidr
锱	zijt
梓	zimu
镞	zuju
邹	zzde
诹	zzyy
偬	zsrx
赀	zivr
阼	zoev
